111111
1P1111
1C11111
1E111111
111111111
1111111111
